100.ox
..o.....oo...........oo......o.o....oo....oo....o.ooo...o......o...o...o..........oo.oo.............
..o.....o...o......o.o......o......o.........o.oo.....o...o.......ooo...o.oo.........o....o...o....o
.....oo..o.....o...o..ooo....o..oo......o....o.o..o.......o...........o.ooo....o.....o...........oo.
.........o...o.....................o.......o................oo...o.o.o......o.............o...oo....
o..o..o.......o..o..o.........o....o.....oo....o......o.......oo.............o.o...o..o.oo..o..o..o.
...oo......o....o..o......o..o..o..o..o...oooo......................oo.o......oo..........o.o..o....
....o....o......o..o...........o.........o...........o..o....o......o.o....o...o.....ooooo..........
.......oo.o......o...oo....o..o...o.....................o.oo......o.o..o..............o..........o..
...........o.o...o..o......o.....o.o....o....o...o....o............o.o.oo...o....o.....o.ooo....o...
o......o....o..............o..oo.o...........o..........o...o.........o.......o.o..o.............o..
.oo...o...o............o.ooo......oo.....o.o.o.....o.oooo..o...oo.....................o..........o.o
..oo.........o....o....o.oo...o...o..oo......o....o.....o.....oooo.......o...o..o..o......o.........
...o.oo...o.......o.o.....o.o......o....ooo....o........o..........o..............o...o....o.o......
..o....o......o.o....o.............o.....o......o..oo....o......o...oo..o..ooo...o.......oo.....oo..
.....o....oo...oo.o.....................o...o.o.....o..........o..oo...o...o.o.............o.....o..
.oo.o....oo...oo..o....o..o..o...o......o..oo........ooo..........o...o......o..o.........o.......o.
...o..o.....o.........o.....o.o.....oo.........o.....o.....o.....o.o.o..o....o...........o........o.
....o....oo...o.....o...........o.o.o.......oo......o.........o......o......o.oo.oo.................
.o..o..o....o.o.o.....o....o.oo........o..o......o....oo.o...............o.....o..o...o...o.........
...o....o..............o..oo..........o..o..o..ooo.....o.o..............o.o.oo.......o....o.o......o
..oo.oo.......o..o..o.........o......o..o.o....o.......o........................o..o......o...o...o.
.o......oo.....o...o....................o.oo..oo...o.o........o..o.....o........o.o.o.....o.........
.....o.o....oo..o........o................o..o.....o......o...o..o.........oo...o...oo.............o
...........ooo...o......o.o..o..o.......................o....o.o..ooo..o........o......o.....o....o.
......o........o...o..o........oooo..........o.o....oo..........o.........o...o...o.....ooo...o.oo..
..ooo.....o....o...o.o.o.o.......o....o..oo..oo..oo...............o...o........o.oo..............o..
....o............o.o........o....o.......oo.o..o........o.............o....oo.oo..oo..o....o.......o
............o.o...oo......oo..oo..........o........o.o.....o....o..o..o.o.....o......ooo.o..ooo..o..
.o...o.o...............o.....o............oo.o.o........o..o......o.......o.o.oo..oo........oo......
......o.o...........o..o...o..o.........oo..o.......oo...........o.....oo....o.....o............o.o.
.....o.o.....o..........o..o..o.......o......o.....oo......o...o......oo..o..o..o.o.....o.o.........
o.....o..o....o.....oo..........o.o...o...............o........o.o.........o....o.o....ooo.......o..
.....o...o...oo......o.o....o.o.......o.o.........................o.o.ooo.o..o..o.o..oo...oo.o......
.o..o.......o.....oo.oo...oo.........o...o.o.o.o.......o.o.o...................o........oo.........o
....o..o.o...........o...oo...o.o...ooo............o..o....oo......o...o.........o......o..o..o.....
..o...o....oo.......o....ooo..oo....o...........o.............o.....o..............o.oo.o......oo...
.o...oo..o.........o..o.....o.o......................o.............oo.o.o....o..oo..........o....oo.
.....o......o........o.o..o.......o....oo.o..o.........oo...o....o.o..............o...ooo.....o.....
.....o....o.........o...ooooo.o.ooo.o.......o...o.........o.......o.o..o.o...o......oo.......oo..o..
oo............o..o..o.....oooo.....o...o....o.........o.....oo.......o..oo......o....o...oo..o......
..o...............o.....ooooo...oo.oooo...o................o................o.o....o...o.......o...o
o...o...ooo.o...oo................o.o..........o.o.....o......o...oo........o.o.o......o............
.........o..o..oo..................o......o.oo.........o..oo......o...o...o....o.o..o.o.o....o....o.
.oo....o......o..o.....o......o.............o.....o...o.....o..............o...o....o..o....o....oo.
o.........o...o.......o..o....o....o...oo...o.....o.o....o..o...o..o.o...oo...o..o.......o..o..o....
.......o......oo..o....oo......o............oo...o......o.........oo...............o....o.......oo.o
.........o..................o............o.......o.o................................o.......o.o.....
.o..o.........o.oo.....oo..........o......o..o....o..oo.o....o........o.ooo..o...o..o..o....o.oo.o..
.o..............oo...oo....o.o.........o..........o..........o..o.o.....o...........o..oo....o......
....oo..........................oo...o..o......o...........o...o...o...................o..o......ooo
.....o.........o.......o...o.......oo..o.......o.oo..................o.o.o..o.........o.o.o.oo.....o
..o..o..ooo....o.o....o....oo.....o.................................o.o..o.oo.....o....o.........oo.
..o....o......oo.............oo.......o.....o..o.....o..o....o..........o...................o..oo..o
.........o..o.....oo.....oo...........o.o....oo.o..o....oo..o.o........oo.........o....o..........o.
.......o..o..oo.o....o.o..o..........o.....o....o...........o.........oo..o..o......o......o.o..o...
.o............ooo......o..o.......oo..o....o...o..o.......o.......o..o...o....oo...........o.....o..
.................o..o.o.o........oo..o.o..oo.o....o.......o...ooo.o........o...o...oo...........o...
..o........o.o.........o...o..........o........o....o.o...oo........oo.....o.o.o...o.......o...o....
o...o...........o...oo.o.....o..o.......o..oo....oo..o...oo..o..o.....................o........o....
.o.....o...oo.o........o..o..................o.......o.o.o.o.........oo..oo...o..ooo..........o..o..
oo...o........o.oo.o..o...o.....o......o.....o.....o......o.......o..................o.........oo..o
.o..oo.......o............o.......oo.........o......oo.....o.o....o......o..oo......o...o...o.......
.......oo.oo...o............o......................o..o.............o...o.............o..o..........
.................ooo..............o.oo....o...o..o..o.....oo......o.o...o....o.oo..o..o..o......o..o
o...o...o.......oo.....o..o..o.o..o.....o..oo....o..................o.........o..o................o.
............o...o.o...o.......o...................o.o........o..o......o.o.o....o....o..........o...
..o..o.......o..oo........o..o...o...o......o.....oo..o.....o...o.o.....o...........o....oo.....o...
..oo..o.............................o..oo.......o........o........o....oo.......o..o.....o...o......
o...o...o.....o.o......o...o.o.o.oo...oo.....o..o.........o........o.....o..o..o.o...ooo............
..........o..o.......o..o......oo.....ooo...oo.........o.o.o...o..o.oo..............o...............
.o...o.oo..o....o....o.......ooo.....oo........o...........o......o..o......o.o......o....o..oo..o.o
o..o..o.........o.o....o.....o.............oo.................o................oo..........oo.......
............o...........oo.....o...............ooo...o...oo..o...........o....o........o..o.o.....oo
..oo.o......oooo....o.......o.o..........o.......o...o....o..o........o.......o...o.......o.o.....o.
.o..o........................o.......................o...o.......o...o...o.oo.o........o...o....o...
.....o..o..........o....o.o................o..o.......o..........o........oo..oo..o.......o..o....o.
..o..o..........oo.o..........oo...........o......oo.....o.o.........oo..o..o....o..o........oo...o.
.ooo.o......oo...........o......o.....o...o.....o.........o.o..........o................o....o...o.o
..o...o........ooo..o...o.o....o....o..o....o..o..o.oo...o.........o......oo.......o..o..o..........
o.o..........o..........o.........o.oo...o.....oo...o........ooo.................o........o.o.....o.
......o.o.oo........o.o........ooo...ooo.o.....oo.............o..o....o..o.oo....o.........o........
..o.........................o................oo...oo.....o.....oo................oooooooo..oooo..o..
.o..o......o...o.o.....o.o....oooo...o.o...............o..o........o........o.o......o.o.o..o..o....
...................o...........o..o.....oooo..........o...o................oo..o.....o...o.....oo..o
.o...o...oo..................o.......o......o....o...o..o..........oo.........o.o.oo..........oo....
..........o.o.........o.........oo......oo...oo...ooo.................o.....o........o............oo
........o.........o..oo.....o.........oo.o................o...o.o...o...o..oo..o....o........o..o..o
.o......oo..o.......o..o........................o..o........o..o.o.o.......o.............o.o....o...
..o.o....oo..o.o.o.............o.o...o.o...o..........o......oo...o.o......o.o......oo......o.......
..o...o.o....o....o...o........................o..o........oooo....o.o.........oo....o.......oo.....
..o.o.....o..........ooo.o.o...o.....o............oooo..........ooo.o...o..o.....o.....oo..oo....o..
.ooo..o....o....oo.......o............oo....o.....oo.........o.o.o..o.o............o.o..o..o......o.
....oo..............o....o........o....o.o..o.oo.o.........o.o.o......o.......o......o..........o...
o..o.....o.o.o.o.....o.ooo.o.oo...oo..o.....o........o...o.o.o.o.........o......o..o....o.oooo...ooo
..o......o...o......o...o.......o......o.oo.o.......o..........ooooo...................o...o..oooo..
....o...o...o........o..o.......o..oo......o.o........oo..............o..........o.....o..o....o.o..
..o..oo.......o....o........o..........oo............oo.o.............o.......o......o........o..oo.
.................o..oo.o...............o.......o...................o........o..o.o.....o.o.o.......o
...........o......o...o..o...oo.......o........o.......o........o.o.o...o.o.ooo..o..o.o.o.......o...
..o...o.o....o...o....oo...o.........oo.o..o.........o..o..o...............o.......o.oo...o.........
